{
  "level_1": {
      "blocks" : [
                 "B","B","B","B","B","B","B","B","B","B","B","B","B","B","B",
                 "B","S","E","B","E","E","T","E","E","E","E","E","E","E","B",
                 "B","E","E","B","E","E","E","E","E","E","E","E","E","E","B",
                 "B","E","B","B","B","B","E","E","E","E","E","E","E","E","B",
                 "B","E","E","B","E","E","E","E","E","E","E","E","E","E","B",
                 "B","E","E","E","E","B","E","E","E","E","E","E","E","E","B",
                 "B","E","E","E","B","B","D","D","E","E","E","E","E","E","B",
                 "B","E","E","E","E","E","E","E","E","E","E","E","E","E","B",
                 "B","E","E","E","E","E","E","E","E","E","E","E","E","E","B",
                 "B","E","E","E","E","E","E","E","E","E","E","E","E","E","B",
                 "B","E","E","E","E","E","E","E","E","E","E","E","E","E","B",
                 "B","E","E","E","E","E","E","E","E","E","E","E","E","E","B",
                 "B","E","E","E","E","E","E","E","E","E","E","E","E","E","B",
                 "B","E","E","E","E","E","E","E","E","E","E","E","E","E","B",
                 "B","B","B","B","B","B","B","B","B","B","B","B","B","B","B"
      ],
      "field_width" : "15",
      "field_height" : "15"
  }
}
