{
  "level": {
      "blocks" : [
                 "P","D","E","E","E","E","E","E","E","E",
                 "E","B","E","B","E","B","E","B","E","E",
                 "E","E","E","E","M","E","M","E","E","E",
                 "E","B","E","B","E","B","E","B","M","E",
                 "E","E","M","E","E","E","E","E","E","E",
                 "E","B","E","B","E","B","E","B","E","E",
                 "E","E","E","E","M","E","E","E","E","M"
      ],
      "field_width" : "10",
      "field_height" : "7"
  }
}
