{
  "level": {
      "blocks" : [
                 "D","D","D","D","D","D","D","D","D","D",
                 "D","P","E","D","E","E","E","E","E","D",
                 "D","E","B","D","E","E","B","E","E","D",
                 "D","E","D","D","D","D","E","E","E","D",
                 "D","E","M","D","E","E","E","E","E","D",
                 "D","E","B","E","E","Z","B","E","E","D",
                 "D","D","D","D","D","D","D","D","D","D"
      ],
      "field_width" : "10",
      "field_height" : "7"
  }
}
