{
  "level": {
      "blocks" : [
                 "B","B","B","B","B","B","B","B","B","B",
                 "B","P","E","B","E","E","E","E","E","B",
                 "B","E","E","B","E","E","E","E","E","B",
                 "B","E","B","B","B","B","E","M","E","B",
                 "B","E","M","B","E","E","E","E","E","B",
                 "B","E","E","E","E","B","E","E","E","B",
                 "B","B","B","B","B","B","B","B","B","B"
      ],
      "field_width" : "10",
      "field_height" : "7"
  }
}
