{
  "level": {
      "blocks" : [
                 "E","D","D","D","D","D","D","D","D","D",
                 "E","P","E","D","E","E","E","E","E","D",
                 "D","E","E","D","E","E","E","M","E","D",
                 "D","E","D","D","D","D","E","E","E","D",
                 "D","E","M","D","E","E","E","E","M","D",
                 "D","E","E","E","M","Z","E","E","M","D",
                 "D","D","D","D","D","D","D","D","D","D"
      ],
      "field_width" : "10",
      "field_height" : "7"
  }
}
