{
  "level": {
      "blocks" : [
                 "B","B","B","B","B","B","B","B","B","B",
                 "K","P","E","B","E","E","E","E","E","B",
                 "B","E","E","B","E","E","E","E","E","B",
                 "B","E","B","B","B","B","E","E","E","B",
                 "K","M","E","K","E","E","E","E","E","B",
                 "K","E","E","E","E","B","E","E","Z","B",
                 "M","K","B","B","B","B","B","B","B","B"
      ],
      "field_width" : "10",
      "field_height" : "7"
  }
}
